1111111111111
1C00000100001
1100X01100X01
1P0000E0X0011
1111111111111
