11111111
100PC001
100000E1
11111111
